会場	かいじょう
店員	てんいん
地震	じしん
	または
法律	ほうりつ
確か	たしか
	ガソリン
彼	かれ
	なさる
火	ひ
決して	けっして
	きっと
受ける	うける
無くなる	なくなる
	コンピュータ/コンピューター
連絡	れんらく
進む	すすむ
	すく
間に合う	まにあう
電報	でんぽう
不便	ふべん
息子	むすこ
卒業	そつぎょう
	けが・する
味	あじ
喜ぶ	よろこぶ
	もし
近所	きんじょ
泳ぎ方	およぎかた
小鳥	ことり
払う	はらう
開く	ひらく
億	おく
	よろしい
普通	ふつう
戦争	せんそう
	けんか・する
経験	けいけん・する
見える	みえる
技術	ぎじゅつ
代わり	かわり
非常に	ひじょうに
	ハンドバッグ
続ける	つづける
急行	きゅうこう
中学校	ちゅうがっこう
	ジャム
	アルコール
裏	うら
売り場	うりば
故障	こしょう・する
新聞社	しんぶんしゃ
お・金持ち	かねもち/おかねもち
尋ねる	たずねる
	はっきり
致す	いたす
機会	きかい
凄い	すごい
用意	ようい
	はず
試合	しあい
腕	うで
十分	じゅうぶん
場所	ばしょ
部長	ぶちょう
さ来月	さらいげつ
昔	むかし
	エスカレーター
ご存じ	ごぞんじ
以上	いじょう
着物	きもの
夫	おっと
変	へん
	サンダル
投げる	なげる
暮れる	くれる
正しい	ただしい
天気予報	てんきよほう
隅	すみ
味噌	みそ
気	き
研究室	けんきゅうしつ
	サラダ
	パソコン
深い	ふかい
	スーツ
	いらっしゃる
	いじめる
	ぜひ
番組	ばんぐみ
教育	きょういく
	びっくり・する
	それに
日記	にっき
大事	だいじ
滑る	すべる
焼ける	やける
空気	くうき
飾る	かざる
校長	こうちょう
	オートバイ
	もっとも
星	ほし
決める	きめる
一度	いちど
	ぶどう
辞典	じてん
	まじめ
訳	わけ
	おつり
	ごらんになる
安心	あんしん
西洋	せいよう
家内	かない
	スーツケース
	うれしい
真中	まんなか
競争	きょうそう
	におい
柔らかい	やわらかい
予約	よやく
今度	こんど
皆	みな
沸く	わく
指	ゆび
経済	けいざい
降り出す	ふりだす
試験	しけん
仕方	しかた
堅/硬/固い	かたい
召し上がる	めしあがる
包む	つつむ
申す	もうす
台風	たいふう
娘	むすめ
眠い	ねむい
用	よう
拝見	はいけん・する
漫画	まんが
教会	きょうかい
旅館	りょかん
道具	どうぐ
落る	おちる
寺	てら
釣る	つる
	おもちゃ
放送	ほうそう・する
	やっと
	すり
下りる	おりる
落す	おとす
	とうとう
案内	あんない・する
お見舞い	おみまい
	つき
	サンドイッチ
関係	かんけい
必ず	かならず
	ベル
	もらう
火事	かじ
思う	おもう
運ぶ	はこぶ
消しゴム	けしゴム
伝える	つたえる
御主人	ごしゅじん
文法	ぶんぽう
米	こめ
直す	なおす
彼女	かのじょ
運転手	うんてんしゅ
拾う	ひろう
入院	にゅういん・する
遠慮	えんりょ・する
	ビル
地理	ちり
役に立つ	やくにたつ
揺れる	ゆれる
医学	いがく
砂	すな
回る	まわる
神社	じんじゃ
	けれど/けれども
支度	したく・する
	ほど
	ほめる
君	きみ
相談	そうだん・する
産業	さんぎょう
工業	こうぎょう
特別	とくべつ
	たいてい
恥ずかしい	はずかしい
屋上	おくじょう
輸入	ゆにゅう・する
	のど
下げる	さげる
久しぶり	ひさしぶり
今夜	こんや
移る	うつる
	もうすぐ
	ほとんど
引き出す	ひきだす
光る	ひかる
政治	せいじ
反対	はんたい
光	ひかり
亡くなる	なくなる
注射	ちゅうしゃ
心	こころ
贈り物	おくりもの
例えば	たとえば
大体	だいたい
水泳	すいえい
港	みなと
	アクセサリー
厳しい	きびしい
	しかる
研究	けんきゅう
葉	は
触る	さわる
美術館	びじゅつかん
	つもり
自由	じゆう
割合	わりあい
注意	ちゅうい
	こと
表	おもて
楽む	たのしむ
	ピアノ
高校生	こうこうせい
乾く	かわく
	ねだん
	かまう
間違える	まちがえる
	ねっしん
	コンサート
沸かす	わかす
	たまに
熱	ねつ
	だから
君	くん
写す	うつす
気持ち	きもち
社会	しゃかい
空く	あく
	そんな
約束	やくそく
泊まる	とまる
	なるほど
考える	かんがえる
	あ
間	あいだ
小説	しょうせつ
	まず
	ステーキ
	そろそろ
決る	きまる
	ああ
席	せき
	なるべく
	あんな
打つ	うつ
	もちろん
花見	はなみ
	かっこう
木綿	もめん
季節	きせつ
警察	けいさつ
彼ら	かれら
	すると
輸出	ゆしゅつ・する
	このあいだ
興味	きょうみ
	テキスト
虫	むし
割れる	われる
	カーテン
手袋	てぶくろ
倍	ばい
珍しい	めずらしい
	いっぱい
社長	しゃちょう
会話	かいわ
日	ひ
焼く	やく
	いただく
探す	さがす
駐車場	ちゅうしゃじょう
	プレゼント
首	くび
合う	あう
子	こ
驚く	おどろく
人形	にんぎょう
危険	きけん
込む	こむ
踊る	おどる
祈る	いのる
親	おや
布団	ふとん
	チェック・する
	それほど
鏡	かがみ
踏む	ふむ
市民	しみん
講義	こうぎ
捕まえる	つかまえる
最近	さいきん
飛行場	ひこうじょう
工場	こうじょう
海岸	かいがん
棚	たな
看護婦	かんごふ
簡単	かんたん
お土産	おみやげ
	そんなに
歯医者	はいしゃ
運動	うんどう・する
糸	いと
	あかちゃん
予習	よしゅう
訪ねる	たずねる
会議室	かいぎしつ
連れる	つれる
公務員	こうむいん
動く	うごく
	さっき
下着	したぎ
無理	むり
以外	いがい
	くれる
寂しい	さびしい
安全	あんぜん
空港	くうこう
お祝い	おいわい
育てる	そだてる
国際	こくさい
気分	きぶん
比べる	くらべる
背中	せなか
	だめ
済む	すむ
お嬢さん	おじょうさん
心配	しんぱい・する
折れる	おれる
	これから
準備	じゅんび・する
招待	しょうたい・する
交通	こうつう
寄る	よる
	すっと
科学	かがく
赤ん坊	あかんぼう
大分	だいぶ
	おかげ
祖母	そぼ
高校	こうこう
	ケーキ
遊び	あそび
起す	おこす
止める	とめる
事務所	じむしょ
食料品	しょくりょうひん
お宅	おたく
特に	とくに
湖	みずうみ
出発	しゅっぱつ・する
	アフリカ
以下	いか
適当	てきとう
漬ける	つける
選ぶ	えらぶ
	どんどん
乗り換える	のりかえる
夢	ゆめ
見つかる	みつかる
	ちっとも
冷える	ひえる
女性	じょせい
壊す	こわす
	おいでになる
祖父	そふ
血	ち
	ソフト
終わり	おわり
動物園	どうぶつえん
失敗	しっぱい
周り	まわり
運転	うんてん・する
市	し
過ぎる	すぎる
手伝う	てつだう
	あいさつ・する
先輩	せんぱい
髪	かみ
戻る	もどる
昼休み	ひるやすみ
説明	せつめい
生活	せいかつ・する
両方	りょうほう
遠く	とおく
生産	せいさん・する
上る	あがる
壁	かべ
線	せん
足す	たす
力	ちから
翻訳	ほんやく
将来	しょうらい
理由	りゆう
枝	えだ
字	じ
展覧会	てんらんかい
植える	うえる
都合	つごう
騒ぐ	さわぐ
最後	さいご
	テニス
具合	ぐあい
親切	しんせつ
妻	つま
遅れる	おくれる
直る	なおる
止む	やむ
規則	きそく
集る	あつまる
指輪	ゆびわ
数学	すうがく
治る	なおる
歴史	れきし
参る	まいる
	ステレオ
行う	おこなう
押し入れ	おしいれ
鳴る	なる
美しい	うつくしい
発音	はつおん
意見	いけん
噛む	かむ
送る	おくる
通る	とおる
	ガス
冷房	れいぼう
謝る	あやまる
	あげる
客	きゃく
	このごろ
高等学校	こうとうがっこう
原因	げんいん
留守	るす
	しっかり
帰り	かえり
途中	とちゅう
汚れる	よごれる
浅い	あさい
	すばらしい
怒る	おこる
絹	きぬ
	ファックス
	ずいぶん
時代	じだい
細かい	こまかい
林	はやし
付く	つく
下宿	げしゅく
	おっしゃる
楽しみ	たのしみ
森	もり
	レポート/リポート
住所	じゅうしょ
捨てる	すてる
承知	しょうち・する
湯	ゆ
	アナウンサー
	ぬれる
畳	たたみ
品物	しなもの
答	こたえ
	ひどい
届ける	とどける
貿易	ぼうえき
取り替える	とりかえる
思い出す	おもいだす
知らせる	しらせる
必要	ひつよう
明日	あす
計画	けいかく・する
音	おと
舟	ふね
別れる	わかれる
忘れ物	わすれもの
お礼	おれい
	うち
	アルバイト
課長	かちょう
笑う	わらう
	ちゃん
勝つ	かつ
壊れる	こわれる
雲	くも
	すっかり
通う	かよう
僕	ぼく
男性	だんせい
	うん
	ガラス
続く	つづく
	ぜんぜん
利用	りよう
止める	やめる
負ける	まける
迎える	むかえる
聞こえる	きこえる
	ごちそう
申し上げる	もうしあげる
	ごみ
集める	あつめる
差し上げる	さしあげる
向かう	むかう
坂	さか
見つける	みつける
調べる	しらべる
柔道	じゅうどう
	じゃま
復習	ふくしゅう
倒れる	たおれる
世界	せかい
	こう
人口	じんこう
下る	さがる
さ来週	さらいしゅう
眠る	ねむる
怖い	こわい
趣味	しゅみ
片付ける	かたづける
引っ越す	ひっこす
別	べつ
習慣	しゅうかん
苦い	にがい
郊外	こうがい
	うそ
受付	うけつけ
点	てん
	うまい
	レジ
草	くさ
暖房	だんぼう
悲しい	かなしい
残る	のこる
建てる	たてる
返事	へんじ
始める	はじめる
二階建て	にかいだて
泥棒	どろぼう
踊り	おどり
残念	ざんねん
	アジア
掛ける	かける
折る	おる
都	と
太る	ふとる
予定	よてい
寝坊	ねぼう
	ガソリンスタンド
水道	すいどう
形	かたち
	ひげ
入学	にゅうがく・する
汽車	きしゃ
世話	せわ・する
	パート
	おかしい
大学生	だいがくせい
痩せる	やせる
変わる	かわる
塗る	ぬる
	やはり/やっぱり
景色	けしき
為	ため
見物	けんぶつ
一生懸命	いっしょうけんめい
毛	け
変える	かえる
	しばらく
慣れる	なれる
	スクリーン
以内	いない
盗む	ぬすむ
似る	にる
退院	たいいん・する
石	いし
泣く	なく
盛ん	さかん
足りる	たりる
講堂	こうどう
	タイプ
	できるだけ
中々	なかなか
丁寧	ていねい
複雑	ふくざつ
最初	さいしょ
	くださる
会議	かいぎ
優しい	やさしい
小学校	しょうがっこう
食事	しょくじ・する
	そう
島	しま
	とこや
逃げる	にげる
特急	とっきゅう
田舎	いなか
急ぐ	いそぐ
用事	ようじ
場合	ばあい
出席	しゅっせき・する
紹介	しょうかい
急	きゅう
電灯	でんとう
事故	じこ
	ワープロ
引き出し	ひきだし
増える	ふえる
文学	ぶんがく
昼間	ひるま
乗り物	のりもの
立てる	たてる
生きる	いきる
	アメリカ
	うかがう
お祭り	おまつり
	それで
文化	ぶんか